000004670
009200801
007613049
050100284
010000396
496800050
300061020
085400060
900078000